111000011
120000010
100000000
000020000
000222010
000120100
101000000
111000002
110000022
02
030080
050081