111111111
100000001
000000000
000000000
001000000
000100000
000000000
000000000
100000001
01
041290