122211111
121211111
000000011
000000001
100220001
100220001
100000001
110000000
110000000
02
032085
052083