111111111
100060001
100010011
100010001
033263320
001010100
010010000
000000010
440000044
04
011080
131091
051082
071091
