000000000
000000000
002302100
002606200
000000000
002606200
002202200
000000000
000000000
03
011070
144091
182180