100303001
006030600
000101000
010111000
112000210
010000110
000020000
110000011
110000011
05
040190
003093
005095
131191
242093
