111111111
000000000
222120000
220120012
000130000
122000001
100200011
105000011
105000111
05
001180
021180
041092
061094
381091