000201111
000101121
000101121
211101121
000000000
002001000
000100200
020000020
111000111
05
140189
000091
284181
007092
087084