110220011
110220011
200220001
210122000
201220000
200221010
200220100
200220000
200000111
05
620281
584181
718481
022180
063390