000000000
000000100
011000110
221122222
222222222
222222222
010000010
011000110
000000000
05
100071
140180
180271
108360
188471