116111611
666666661
611161161
610000000
610606060
610000000
610606060
660010100
110000000
05
123270
283181
344261
446370
645285