006600006
000060006
000060000
600020000
000202060
000020006
000000000
600000000
006006000
05
544990
544761
544540
544451
544370