000101000
022200022
122260022
000606022
006040600
222606011
222060001
100000222
110000222
05
740971
644851
544761
400631
380541
