111111111
111111111
111111111
111111111
000000000
066606666
061606106
066606606
100000000
05
104901
224901
344901
464900
584900