111111111
111111111
100000001
160601061
100606001
160606061
100106001
160060061
100000001
08
742900
622901
562900
423901
363900
244901
145900
046901